********************
*       ***        *
*         *   *    *
* *********   *    *
*S        *   *   E*
*   *******   *    *
*         *   *    *
*             *    *
********************
