**************
*     *      *
*S    *     E*
*     *      *
*            *
**************
